1,4
-4,-4
99,99,1,99,99,99,99,99,99
99,99,1,99,1,1,1,99,99
99,99,1,99,1,99,1,99,99
99,99,1,99,1,99,1,99,99
99,99,1,99,1,99,1,99,99
1,1,1,1,1,1,1,1,0
1,99,1,1,1,1,1,99,99
1,99,1,99,99,99,99,99,99
1,1,1,99,99,99,99,99,99
